20 20
100 100
21  21  21  21  21  21  21  21  21  21  21  21  21  21  21  21  21  21  21  21 
21  20 19 18 20 20 26 15 15 15 15 15 15 15 15 23 18 19 18 20
21  26 15 15 15 15 12 22 22 22 22 22 22 22 22 13 15 15 15 15
21  16 22 22 22 22 22 22 22 22 22 22 22 22 22 22 22 22 11 14
21  24 14 14 14 14 14 14 14 14 14 14 14 14 14 10 22 22 17 18
21  18 19 20 18 19 20 20 18 19 20 18 19 20 20 16 22 22 17 21
21  20 18 19 20 20 18 19 20 18 19 20 20 18 19 16 22 22 17 21
21  16 15 15 15 15 15 15 15 15 15 15 15 15 15 12 22 22 17 21
21  16 14 14 14 14 14 14 14 14 14 14 14 14 14 10 22 22 17 21
21  18 19 20 18 19 20 20 18 19 20 18 19 20 20 16 22 22 17 21
21  19 18 20 20 18 19 18 20 20 18 19 18 20 20 16 22 22 17 21
21  20 19 18 20 20 26 15 15 15 15 15 15 15 15 12 22 22 13 15
21  26 15 15 15 15 12 22 22 22 22 22 22 22 22 22 22 22 22 22
21  16 22 22 22 22 22 22 22 22 22 22 22 22 22 22 22 22 11 14
21  24 14 14 14 14 14 14 14 14 14 14 14 14 14 10 22 22 17 18
21  18 19 20 18 19 20 20 18 19 20 18 19 20 20 16 22 22 17 21
21  20 18 19 20 20 18 19 20 18 19 20 20 18 19 16 22 22 17 21
21  16 15 15 15 15 15 15 15 15 15 15 15 15 15 12 22 22 17 21
21  19 18 20 20 18 19 18 20 20 18 19 18 20 20 18 19 18 20 20
21  21 21 21 21 21 21 21 21 21 21 21 21 21 21 21 21 21 21 21