30 30	
100 100
4 4 4 4 4 4 4 4 4 4 4 4 4 4 4 4 4 4 4 4 4 4 4 4 4 4 4 4 4 4
4 5 5 5 5 5 5 5 5 5 5 5 5 5 5 5 5 5 6 6 6 6 6 6 6 6 6 6 6 4
4 5 5 5 5 5 5 5 5 5 5 5 5 5 5 5 5 5 5 5 6 6 6 6 6 6 6 6 6 4
4 5 5 5 5 5 5 5 5 5 5 5 5 5 5 5 5 5 5 5 5 5 6 6 6 6 6 6 6 4
4 5 5 5 5 5 5 5 5 5 3 3 3 3 3 3 3 3 3 3 3 3 6 6 6 6 6 6 6 4
4 5 5 5 5 5 5 5 5 3 3 3 3 3 3 3 3 3 3 3 3 3 3 6 6 6 6 6 6 4
4 5 5 5 5 5 5 5 5 3 3 3 3 7 7 7 7 7 7 7 3 3 3 6 6 6 6 6 6 4
4 5 5 5 5 5 5 5 5 3 3 3 3 7 7 6 6 6 7 7 3 3 3 6 6 6 6 6 6 4
4 5 5 5 5 5 5 5 5 5 5 3 3 7 7 6 6 6 7 7 3 3 6 6 6 6 6 6 6 4
4 5 5 5 5 5 5 5 5 5 5 5 3 3 7 7 6 7 7 3 3 3 6 6 6 6 6 6 6 4
4 5 5 5 5 5 5 5 5 5 5 5 5 3 3 3 3 7 7 3 3 6 6 6 6 6 6 6 6 4
4 5 5 5 5 5 5 5 5 5 5 5 5 5 5 5 5 5 5 5 5 5 5 5 5 5 5 5 5 4
4 5 5 5 5 5 5 5 5 5 5 5 5 5 5 5 5 5 5 5 5 5 5 5 5 5 5 5 5 4
4 5 5 5 5 5 5 5 0 0 0 0 0 0 0 0 0 0 0 0 0 0 0 0 0 0 0 0 0 4 
4 0 0 0 0 0 0 0 0 0 0 0 0 0 0 0 0 0 0 0 0 0 0 0 0 0 0 0 0 4
4 4 4 4 0 0 0 0 0 0 0 0 0 0 0 0 0 0 0 0 0 0 0 0 0 0 4 4 4 4
4 4 4 4 4 4 4 4 4 0 0 0 0 0 0 0 0 0 0 0 0 4 4 4 4 4 4 4 4 4 
4 4 4 4 4 0 0 0 0 0 0 0 0 0 2 2 2 2 0 0 0 0 0 0 4 4 4 4 4 4
4 0 0 0 0 0 0 0 0 0 0 0 0 2 2 2 2 2 2 0 0 0 0 0 0 0 0 0 0 4
4 5 5 5 5 5 5 5 5 5 5 5 5 5 5 5 5 5 5 5 6 6 6 6 6 6 6 6 6 4
4 5 5 5 5 5 5 5 5 5 5 5 5 5 5 5 5 5 5 5 5 5 6 6 6 6 6 6 6 4
4 5 5 5 5 5 5 5 5 5 3 3 3 3 3 3 3 3 3 3 3 3 6 6 6 6 6 6 6 4
4 5 5 5 5 5 5 5 5 3 3 3 3 3 3 3 3 3 3 3 3 3 3 6 6 6 6 6 6 4
4 5 5 5 5 5 5 5 5 3 3 3 3 7 7 7 7 7 7 7 3 3 3 6 6 6 6 6 6 4
4 5 5 5 5 5 5 5 5 3 3 3 3 7 7 6 6 6 7 7 3 3 3 6 6 6 6 6 6 4
4 5 5 5 5 5 5 5 5 5 5 3 3 7 7 6 6 6 7 7 3 3 6 6 6 6 6 6 6 4
4 5 5 5 5 5 5 5 5 5 5 5 3 3 7 7 6 7 7 3 3 3 6 6 6 6 6 6 6 4
4 5 5 5 5 5 5 5 5 5 5 5 5 3 3 3 3 7 7 3 3 6 6 6 6 6 6 6 6 4
4 5 5 5 5 5 5 5 5 5 5 5 5 5 5 5 5 5 5 5 5 5 5 5 5 5 5 5 5 4
4 4 4 4 4 4 4 4 4 4 4 4 4 4 4 4 4 4 4 4 4 4 4 4 4 4 4 4 4 4
