20 8
100 100
21 21 21 21 21 21 21 21 21 21 21 21 21 21 21 21 21 21 21 21
21 19 18 20 20 18 19 18 20 20 18 19 18 20 20 18 19 18 20 21
21 20 19 18 20 20 26 15 15 15 15 15 15 15 15 23 18 19 18 21
21 15 15 15 15 15 12 22 22 22 22 22 22 22 22 22 22 22 22 21
21 22 22 22 22 22 22 22 22 22 22 22 22 22 22 22 22 22 11 21
21 14 14 14 14 14 10 11 14 14 14 14 14 14 10 22 22 22 17 21
21 18 19 20 20 18 16 17 18 19 20 20 18 19 16 22 22 22 17 21
21 26 23 19 18 20 16 17 19 20 18 19 20 19 16 22 22 22 13 21